NO test.xpm
SO test.xpm
WE test.xpm
EA test.xpm

F 123,23,43
C 0,32,32

      11111111111111 111
      10000000000001 101
      11111111111101 111
  111111110000000001111
 1000000000001110000001
10000000000001 10000001
 10000000000N1 1000N001
  111111111111 11111111