NO test.xpm
SO test.xpm
WE test.xpm
EA test.xpm

F 123,23,43
C 0,32,32

      11111111111111
      10000000000001
      11111111111101
11111111110000000001111
10000000000001110000001
10000000000001 10000001
100000000000N1 1000N001
11111111111111 11111111